
9
..#######
....#...#
#.###.###
#.......#
#.###.#.#
#.#...#.#
#.#.###.#
#.#.#...#
#######..